10x20

____________________
_________________E__
___________Z________
__ZZZZZZZ__ZZZZZ____
________Z___________
________Z___________
________Z___________
_____ZZZZ_____ZZZ___
__S_________________
____________________