6x11

___________
___ZE______
___ZZZZZ___
___________
_______S___
___________