10x20

___________Z________
___________Z_____E__
___________Z________
__ZZZZZZZ__ZZZZZ____
_______SZ___________
________Z___________
________Z___________
_____ZZZZ_____ZZZ___
____________________
____________________