40x80

________________________________________________________________________________
_________________E______________________________________________________________
___________Z____________________________________________________________________
__ZZZZZZZ__ZZZZZ________________________________________________________________
________Z_______________________________________________________________________
________Z_______________________________________________________________________
________Z_______________________________________________________________________
_____ZZZZ_____ZZZ_______________________________________________________________
________________________________________________________________________________
________________________________________________________________________________
________________________________________________________________________________
________________________________________________________________________________
___________Z____________________________________________________________________
__ZZZZZZZ__ZZZZZ________________________________________________________________
________Z_______________________________________________________________________
________Z_______________________________________________________________________
________Z_______________________________________________________________________
_____ZZZZ_____ZZZ_______________________________________________________________
________________________________________________________________________________
________________________________________________________________________________
________________________________________________________________________________
________________________________________________________________________________
___________Z____________________________________________________________________
ZZZZZZZZZZZZZZZZZZZZZZZZZZZZZZZZZZZZZZZZZZZZZZZZZZZZZZZZZZZZZZZZZZZZZZZZ________
________Z_______________________________________________________________________
________Z_______________________________________________________________________
________Z_______________________________________________________________________
ZZ_ZZZZZZ_____ZZZ_______________________________________________________________
________________________________________________________________________________
_ZZZZ___________________________________________________________________________
____Z___________________________________________________________________________
ZZ__Z___________________________________________________________________________
____Z______Z____________________________________________________________________
_ZZZZZZZZ__ZZZZZ________________________________________________________________
________Z_______________________________________________________________________
________Z_______________________________________________________________________
________Z_______________________________________________________________________
_____ZZZZ_____ZZZ_______________________________________________________________
__S_____________________________________________________________________________
________________________________________________________________________________