6x11

___________
_________E_
Z_ZZZZZZ_ZZ
_______Z_Z_
_______S___
___________