30x54

______________________________________________________
______________________________________________________
______________________________________________________
______________________________________________________
___________________________E__________________________
___________________________ZZZZZZZZZZZZZZZZZZZZ_______
______________________________________________________
____________ZZZZZZZZZZZZZZZZZZZ_______________________
______________________________________________________
_______________Z_______________________Z______________
_______________Z_______________________Z______________
_______________Z_______________________Z______________
_______________Z_______________________Z______________
_______________Z_______________________Z______________
_______________Z__ZZZZZZZZZZZZZZZZZZZ__Z______________
_______________Z_______________________Z______________
_______________Z_______________________Z______________
_______________Z_______________________Z______________
_______________Z_______________________Z______________
_______________Z_______________________Z______________
______________________________________________________
______________________________________________________
________________________ZZZZZZZZZZZ___________________
______________________________________________________
______________________________________________________
_______________________S______________________________
______________________________________________________
______________________________________________________
______________________________________________________
______________________________________________________