30x54

______________________________________________________
______________________ZZZZZZZZ________________________
________ZZZZZZZ_______________________________________
_______________________Z______________________________
____E___Z______________Z______________________________
________Z______________Z______________________________
________Z______________Z______________________________
________Z______________Z_______ZZZZZZZ________________
________Z______________Z______________________________
________Z______________Z_______Z______________________
________Z______________Z_______Z______________________
________Z______________Z_______Z______________________
________Z______________Z_______Z_______ZZZZZZZZ_______
_______________________________Z______________________
___________ZZZZZZZZ____________Z_______Z______________
_______________________________Z_______Z______________
____________Z________ZZZZZZZZ__Z_______Z______________
____________Z__________________Z_______Z______ZZZZZZZZ
____________Z_________Z________Z_______Z______________
____________Z_________Z________________Z______Z_______
____________Z_________Z________________Z______Z_______
____________Z_________Z________________Z______Z_______
____________Z_________Z________________Z______Z_______
____________Z_________Z_______________________Z_______
____________Z_________Z_______________________Z_______
______________________Z_______________________Z_______
______________________Z_______________________Z___S___
______________________________________________Z_______
______________________________________________________
______________________________________________________