10x20

____________________
__ZZ_ZZZZZZZZZ___E__
Z__Z_Z_______ZZZZZZZ
__ZZZZ_ZZZZZ_Z__Z___
_ZZZ_Z_____Z___ZZZ_Z
__ZZ_ZZZZZ_ZZZZZ___Z
Z_Z____________Z_Z_Z
__Z_ZZZZZ_ZZ_Z_ZZZ_Z
_ZZ_Z___Z_Z__Z_Z_Z_Z
______Z______Z____SZ